2121211331313131320130313131311422002021
2121212204000001010103020401032022062021
2121212206050200060201080205042022042021
2121212205020201070203050406032022013031
2121212204010606020104050604022022050403
3131142207161717171717171718022023111111
0000202206262727272727272728062021212121
1205202206363737373737373738032013313131
2205202203000407060504050405012022000106
2204202311111111111111111111112422051011

image image:3
location 1 2 0 0
encodds (u16)-5000 (u16)2000
sprite @7,6 sprite:hero 0x00000000
sprite @9,1 sprite:tolldoor 0x01000000
treasure @11,2 (u16)0
difficulty 0x00 0x40
