3131313131141331320700303131313131313114
0107000101202202010303040001030702040320
1205101201202207020206070206060710120120
2201303201202206010203020600000230320630
2206060202202201051011111205040304000002
2206101111242206063031142200150015020710
2203303131313203020000202200050502040320
2202020200040701040603202205032503250320
2204060110111111111111242202060706010020
2311111124212121212121212204101111111124

image image:3
location 12 12 0 0
encodds (u16)-10000 (u16)1500
sprite @14,3 sprite:hero 0x00000000
sprite @1,1 sprite:tolldoor 0x01000000
sprite @18,4 sprite:tolldoor 0x03000000
sprite @9,1 sprite:tolldoor 0x02000000
sprite @13,8 sprite:tolldoor 0x04000000
