2121212202303131313131313131313114133131
2121212200070200030006040404060620220002
2121212200161717171717171717180420220005
212121220326193737373737371a280220220207
2121212204262810111111111226280320220710
2121212203262830313131313226280420220420
212121220026291717171717172a280720220120
2121212207363737373737373737380430320320
2121212205050104010005000602010704000420
2121212311111111111111111111111111111124

image image:3
location 2 1 *
encodds (u16)-10000 (u16)1500
sprite @18,8 sprite:tolldoor 0x0d000000
sprite @4,1 sprite:tolldoor 0x0e000000
difficulty 0xb0 0xff
