1331313131313131141331313131313131313114
2201010001050307202202030003030604010020
2204101111111206303205101205101111120620
2202202121212201010203202200202121220620
2200202121212204101111242203202121222520
2206202121212206202121212205202121220520
2205202121212204202121212202301421220520
2203303131142203303131313203033031320530
2205070300202206050402020125040006070401
2311111200202311111111111111111111111111

image image:3
location 2 0 *
encodds (u16)-10000 (u16)1500
sprite @7,4 sprite:tolldoor 0x0f000000
sprite @18,8 sprite:tolldoor 0x10000000
