1331313131313131313131313131313131313114
2201020202020707050306010305000105050020
2200040607050107020605020106000301030520
2207050705030506000704050507000203050120
220101060303010402040a010206010300000720
2204020307020204050400070206060104070720
2201050700060301070700060201030300000520
3200020505050302030700010303010106030020
0607010001010502060303030600060305020420
1111111111111111111111111111111111111124

image image:3
location 3 0 *
gameover @10,4
