1331313131313131313131313131313131313114
2207060002000302040302050000070102040220
2202020707010205050304030501050201050220
3200020406070600040402060002070400030120
0002040405010305070305040604040000010420
1205040607030603070501050307000505030420
2207030401010306000505010502050206040720
2206030707070407040701070504020504040620
2207000505040106070202040407050603060020
2311111111111111111111111111111111111124

image image:3
location 13 12 0 0
