1331313131141331313131141331313131142121
2207070301202206060606202202030706202121
2202101201202205101200202201101205202121
3203202202202201202206202203202207202121
0006202205303205202206303205202204202121
1111242202030400202204040504202200303131
2121212311111111242311111111242207070705
3131313131313131313131313131313205101111
0002060207030207000507010600060402202121
1111111111111111111111111111111111242121

image image:3
location 2 2 0 0
encodds (u16)-10000 (u16)1500
sprite @16,6 sprite:tolldoor 0x05000000
difficulty 0x30 0x60
