1331313131313131313131313202303131313114
2206070101070501000401070006020105030520
2203020006000703010600040202010103020220
2201020707050103050507040002040200030020
2203000701030302020001010402040207010520
2202040000070706040005060101040703060320
2202020507030705020704040201030107070020
2205030205020006040707010507040702070720
2206040702030001040507020300040006010620
2311111111111111111111111111111111111124

image image:3
location 12 13 0 0
encodds (u16)-10000 (u16)1500
