1331313131313131313131313131313131313131
2203060501060107060407060601010101000600
2205000000000000000000000000000000000710
2206000000000000000000000000000000000220
2206000000000000000000000000000000000020
2204000000000000000000000000000000000520
2204000000000000000000000000000000000720
2207000000000000000000000000000000000620
2200030002070601020604000402000600000420
2311111111111111111111111111111111111124

image image:3
location 11 12 0 0
