1331313131313131313131313131313131313131
2203040401060107060407060601010101000600
2205020503010704050705000005010107020710
2206020301020404070000000604060205070320
2206070700010607060001020702050404010420
2204030302030701020705040507070603010020
2204020406070307010501050506010507060620
2207000005010402020607000607070404070620
2200030002070601020604000402000600000420
2311111111111111111111111111111111111124

image image:3
location 11 12 0 0
encodds (u16)-10000 (u16)1500
