1331313131313131320330313131313131313114
2206000102020403040000020402030004050520
2204352525151502252525352535353525350220
2203150201062505250307040606020104020320
2200250415252505151535250235351535101124
2225350603060401030706150025010104303131
2204353525001535151525250815041506010006
2207020704030300070606251515011011111111
2311111111111111111202050101072021212121
2121212121212121212311111111112421212121

image image:3
location 0 2 0 0
encodds (u16)-10000 (u16)1500
sprite @18,6 sprite:tolldoor 0x0a000000
treasure @12,6 (u16)2
difficulty 0x30 0x60
