1331313131313131313131313131313131313114
2207020300070600030300060402060001020720
2201040106050706040302030202060204060220
2200070504000507030203070404060105060620
2201030007030603010701070605020502070120
2205050301000300060503000404020001040020
2206000306050102030705020006030705060420
2200010600020706070305020606060504030720
2203030402060601000704000301050501020420
2311111111111111120606101111111111111124

image image:3
location 12 11 0 0
