1331313131313131313131313131320430313114
2207020304030000030300060402070407020720
3200020100350206000402030202060204060220
0500150303050006350003060300000103050020
1202060506030005020405101111111111120320
2216171717171717171800202121212121220620
2226272727272727272806202121212121220020
2226272727272727272805303131313131320520
2236373737373737373802070201060000060020
2311111111111111120310111111111112021024

image image:3
location 1 1 0 0
encodds (u16)-10000 (u16)1500
sprite @17,8 sprite:tolldoor 0x02000000
sprite @1,3 sprite:tolldoor 0x03000000
sprite @15,1 sprite:tolldoor 0x04000000
difficulty 0x00 0x40
