2121212121212121212121212121212121212121
2121212121211331313131313131313131311421
2121212121212201070702050600010206023031
2121212121212206030701070701000604010100
2121212121212203011011111111111200041011
2121212121212201073031313131313200022021
2121212121212201050600010205000301012021
2121212121212204070505070506050404012021
2121212121212311120510111111111111112421
2121212121212121220120212121212121212121

image image:3
location 0 1 *
encodds (u16)-10000 (u16)1500
sprite @9,7 sprite:tolldoor 0x09000000
