2121212204202121212204202121212207202121
2121212200202121212202202121212200202121
1331313202303131313202303131313203303114
2202040303010500020401070605040603000020
2204060107000406030500040603020205040520
3202040106060104000300070201060203070220
0105070702050303070102030101020207030620
1216171717171717171717171717171717171820
2236373737373737373737373737373737373820
2311111111111111111111111111111111111124

image image:3
location 3 2 *
encodds (u16)-10000 (u16)1500
sprite @16,3 sprite:tolldoor 0x08000000
sprite @4,3 sprite:tolldoor 0x06000000
sprite @10,3 sprite:tolldoor 0x07000000
