3131313131313131313131142121212121212121
0306060602040703070507202121212121212121
0000000000000000000007202121212121212121
0501030103030302060306201331313131142121
1111111111111111111205202202020103202121
212121133131313114220d2022030b0406202121
2121212204010507202200202207040701202121
2121212201070b0220220d202311111204202121
2121212202060102202200202121212201202121
2121212201101111242204202121212202202121

image image:3
location 3 1 *
encodds (u16)-10000 (u16)1500
switchable @10,7 (u16:flag)leftgate
switchable @10,5 (u16:flag)rightgate
treadle1 @6,7 (u16:flag)leftgate
treadle1 @14,5 (u16:flag)rightgate
