3131313131313131313131141331313131142121
0306060602040703070507202205060204202121
0000000000000000000007202202000005202121
0501030103030302060306202201020204202121
1111111111111111111203202311111207202121
2121211331313131142203202121212203202121
2121212204060005202203202121212204202121
2121212201000003202202202121212204202121
2121212202070205202206202121212201202121
2121212201101111242204202121212202202121

image image:3
location 3 1 *
encodds (u16)-10000 (u16)1500
