2121212121212121212121212121212121212121
2121212121212121212121212121212121212121
2121212121212121212121212113313131142121
2121212121212121212121212122070100202121
2121212121212121212121212122050801202121
2121212121212121212121212122030307202121
2121212121212121212121212123120010242121
2121212121212121212121212121220420212121
2121212121212121212121212121220620212121
2121212121212121212121212121220220212121

image image:3
location 1 0 *
encodds (u16)-10000 (u16)1500
treasure @15,4 (u16)1
difficulty 0x00 0x40
